XXXXXXXXXXXXXXXXXXXXXXXXXXXXXXXX
PXXXXXX1XXXXPXXXXXXPXXXXXXXXXXXX
##XXXXXXXXXXXXXXXXX#____#XXXXXXX
TTXXXXXXXXXXXXXXXXXX####XXXXXXXX
XXXXXXX#XXXX#XXXXXXXTTTTXXXXXXXX
XXXXXXXXXXXXXXXXXXXXXXXXXXXXSXXX
XXXXXXXXXXXXXXXXXXXXXXXXXXX###XX
XXXSXXXXXXXXXXXXXXXXXXXXXXXXXXXX
XX###XXXXXXX#____#XXXXXXXXXXXXXX
XXXXXXXXXXXXX####XXXXXPXXXXXXXXX
XXXXXXXXXXXXXXXXXXXXX###XXXXXXXX
XXXXXXXXXXXXXXXXXXXXXXXXXXXXXXXX
XXXXX#___#XXXXXXXXXXXXXXXXXXX2XX
XXXXXX###XXXXXXXXXXXXXXXXXXX###X
XXXXXXTTTXXX###XXXXXXXXXXXXXTTTX
XXXXXXXXXXXXXXXXXXXXXXXXXXXXXXXX
X1XXXXXXXXXXXXXXXXXXXXXXXXXXXX2X
################################