#XXXXXXXXXXXXXXXXXXXXXXX2X#XXXX#
#XXXXXXXX2XX1XXXXXXPXXXXXX|XXXX#
#XXXXXXXXXXXXXXXXXXXXXXXXX|XXXX#
#XPXXXXXXXXXXXXXXXXXXXXXXX|XXXX#
#XXXXX#XXXXXXXXXXXXXXXXX###XXXX#
#XXXXX|XXXXXXXXXXXXXXXXXTTTXXXX#
#XXXXX|XXXXXXXXX##XXXXXXXXXXXXX#
#XXXXX|PXXXXXXXXXXXXXXXXXXXXXXX#
#XXXXX##XXXXXXXXXXXXXXXXXXXXXPX#
#XXXXX|XXXXXXXXXXXXXX##XXXXXX#X#
#XXXXX|XXXXXXXXXXXXXXXXXXXXXXXX#
#X##XX|XXXXXXX##XXXXXXXXXXXXXXX#
#XTTXX|XXXXXXXTTXXXXXXXXXXXXXXX#
#XXXXX|XXXXXXXXXXXXXXXX##XXXXXX#
#XXXXX|XXXXXXXXXXXXXXXXXXXXXXXX#
#XXXXS|XXXXXXXXXXXXSXXXXXXX1XXX#
#XXX###XXXX##XXXXXX##XXXXX##XXX#
#//////////////////////////////#