#XXXXXXXXXXXXXXXXXXXXXXXXXXXXXX#
#XXXXXXXXXXXXXX1XXXXXXXXXXXXXXX#
#XXXXXXXXXXXXXX#XXXXXXXXXXXXXXX#
#XXXXXXXXXXXXXXXXXXXXXXXXXXXXXX#
#XXXXXXXXPXXXXXXXXXXXXPXXXXXXXX#
#XXXXXX######//////######XXXXXX#
#XXXXXXTTTTTT######TTTTTTXXXXXX#
#XXXXXXXXXXXXXXXXXXXXXXXXXXXXXX#
#XXXXXXXXXXXXXXXXXXXXXXXXXXXXXX#
#X##XXXXXXXXXXXXXXXXXXXXXXXX##X#
#XXXXXXXXXXXXXXXXXXXXXXXXXXXXXX#
#XXXXXXXXXXXXXXXXXXXXXXXXXXXXXX#
#XXXXXXXXSXXXXXXXXXXXXSXXXXXXXX#
#XXXXXX#######XXX########XXXXXX#
#XXXXXXXXXXXX|XXX|XXXXXXXXXXXXX#
#XPXXXXXXXXXX|XXX|XXXXXXXXXXXPX#
#X#XXXXXXXX1X|XXX|XX1XXXXXXXX#X#
#////////##############////////#